00000000
0E111110
00000010
0111P010
01001010
01000010
01111110
00000000
