00000000
03111110
00000010
01112010
01001010
01000010
01111110
00000000
